.--+.-,--+--.--+
|           *  ,
+  +--.--+  +  +
.  |     |     *
+  +--.  +--+  +
|     ,     |  *
+--+  +- +  +  +
|   g |  ,     *
+  +**+--+   **+
.        .     *
+--.--+--,--+*.+