.-,+--.--+--,--+
|           *  |
+  +--,--+  +  +
,  |     |     *
+  +--+  +-,+  +
|     |     |  *
,--+  ,--+  .  +
|     |  ,     *
+  +--+  +  .**+
|        |     g
.--+--+--,--+**+
