.--+.-,--+--.--+
|           *  ,
+  +--.--+  +  +
.  |  g  |     *
+  +--.  +--+  +
|     ,     |  *
+--+  +- +  +  +
|     |  ,     *
+  +**+--+   **+
.        .     *
+--.--+--,--+*.+
